Id,Geography,Target Geo Id,Target Geo Id2,Pop Apr 1,Pop Jul 1,Change Pop
0100000US,United States,310M400US10100,10100,40603,43191,2588
0100000US,United States,310M400US10140,10140,72798,73901,1103
0100000US,United States,310M400US10220,10220,37490,38247,757
0100000US,United States,310M400US10300,10300,99892,98266,-1626
0100000US,United States,310M400US10460,10460,63832,66781,2949
0100000US,United States,310M400US10620,10620,60586,62075,1489
0100000US,United States,310M400US10660,10660,31254,30444,-810
0100000US,United States,310M400US10700,10700,93019,96109,3090
0100000US,United States,310M400US10760,10760,41618,40497,-1121
0100000US,United States,310M400US10820,10820,36009,37964,1955
0100000US,United States,310M400US10860,10860,40836,40822,-14
0100000US,United States,310M400US10940,10940,42476,40599,-1877
0100000US,United States,310M400US10980,10980,29601,28360,-1241
0100000US,United States,310M400US11060,11060,26446,24949,-1497
0100000US,United States,310M400US11140,11140,37827,34969,-2858
0100000US,United States,310M400US11220,11220,50258,49455,-803
0100000US,United States,310M400US11380,11380,14786,18128,3342
0100000US,United States,310M400US11420,11420,34173,34586,413
0100000US,United States,310M400US11580,11580,34862,37489,2627
0100000US,United States,310M400US11620,11620,47733,48177,444
0100000US,United States,310M400US11660,11660,22993,22061,-932
0100000US,United States,310M400US11680,11680,36309,35218,-1091
0100000US,United States,310M400US11740,11740,53140,53745,605
0100000US,United States,310M400US11780,11780,101490,97493,-3997
0100000US,United States,310M400US11820,11820,37026,39764,2738
0100000US,United States,310M400US11860,11860,16921,16193,-728
0100000US,United States,310M400US11900,11900,64764,65818,1054
0100000US,United States,310M400US11940,11940,52279,53285,1006
0100000US,United States,310M400US11980,11980,78534,82299,3765
0100000US,United States,310M400US12120,12120,38320,36748,-1572
0100000US,United States,310M400US12140,12140,42229,43226,997
0100000US,United States,310M400US12180,12180,80017,77145,-2872
0100000US,United States,310M400US12300,12300,122154,122083,-71
0100000US,United States,310M400US12380,12380,39163,40011,848
0100000US,United States,310M400US12460,12460,27842,26575,-1267
0100000US,United States,310M400US12660,12660,61965,64249,2284
0100000US,United States,310M400US12680,12680,43443,45851,2408
0100000US,United States,310M400US12740,12740,59522,58140,-1382
0100000US,United States,310M400US12780,12780,50977,51843,866
0100000US,United States,310M400US12820,12820,27979,25398,-2581
0100000US,United States,310M400US12860,12860,59943,57511,-2432
0100000US,United States,310M400US12900,12900,36641,37678,1037
0100000US,United States,310M400US13060,13060,36702,36552,-150
0100000US,United States,310M400US13100,13100,22311,21493,-818
0100000US,United States,310M400US13180,13180,88759,87847,-912
0100000US,United States,310M400US13260,13260,46129,45668,-461
0100000US,United States,310M400US13300,13300,31861,32587,726
0100000US,United States,310M400US13340,13340,45851,45358,-493
0100000US,United States,310M400US13420,13420,44442,46847,2405
0100000US,United States,310M400US13500,13500,28935,26398,-2537
0100000US,United States,310M400US13540,13540,37125,35631,-1494
0100000US,United States,310M400US13620,13620,39358,37839,-1519
0100000US,United States,310M400US13660,13660,42798,43545,747
0100000US,United States,310M400US13700,13700,36238,37847,1609
0100000US,United States,310M400US13720,13720,61320,56503,-4817
0100000US,United States,310M400US13940,13940,45605,46236,631
0100000US,United States,310M400US14140,14140,107333,99986,-7347
0100000US,United States,310M400US14180,14180,46480,41239,-5241
0100000US,United States,310M400US14220,14220,47140,46582,-558
0100000US,United States,310M400US14300,14300,33910,35286,1376
0100000US,United States,310M400US14340,14340,26308,26346,38
0100000US,United States,310M400US14380,14380,51057,55945,4888
0100000US,United States,310M400US14420,14420,22249,21198,-1051
0100000US,United States,310M400US14580,14580,89513,111876,22363
0100000US,United States,310M400US14620,14620,43459,40968,-2491
0100000US,United States,310M400US14660,14660,91077,94408,3331
0100000US,United States,310M400US14700,14700,83885,87601,3716
0100000US,United States,310M400US14720,14720,27994,31007,3013
0100000US,United States,310M400US14780,14780,33695,35108,1413
0100000US,United States,310M400US14820,14820,33091,34215,1124
0100000US,United States,310M400US15020,15020,34870,34205,-665
0100000US,United States,310M400US15060,15060,22365,22813,448
0100000US,United States,310M400US15100,15100,31962,35232,3270
0100000US,United States,310M400US15140,15140,18807,17335,-1472
0100000US,United States,310M400US15220,15220,38106,37924,-182
0100000US,United States,310M400US15340,15340,43783,41550,-2233
0100000US,United States,310M400US15420,15420,43019,44689,1670
0100000US,United States,310M400US15460,15460,47653,45847,-1806
0100000US,United States,310M400US15580,15580,34209,34993,784
0100000US,United States,310M400US15620,15620,47586,48579,993
0100000US,United States,310M400US15660,15660,55186,57685,2499
0100000US,United States,310M400US15700,15700,32623,31998,-625
0100000US,United States,310M400US15740,15740,40091,39022,-1069
0100000US,United States,310M400US15780,15780,31496,28883,-2613
0100000US,United States,310M400US15820,15820,24500,25549,1049
0100000US,United States,310M400US15860,15860,46824,48021,1197
0100000US,United States,310M400US15900,15900,37069,34844,-2225
0100000US,United States,310M400US16100,16100,53823,57900,4077
0100000US,United States,310M400US16140,16140,20816,20154,-662
0100000US,United States,310M400US16260,16260,46163,52775,6612
0100000US,United States,310M400US16340,16340,41479,42470,991
0100000US,United States,310M400US16380,16380,40814,40959,145
0100000US,United States,310M400US16420,16420,31499,30774,-725
0100000US,United States,310M400US16460,16460,39437,37620,-1817
0100000US,United States,310M400US16500,16500,75457,79604,4147
0100000US,United States,310M400US16660,16660,64921,61693,-3228
0100000US,United States,310M400US17060,17060,78078,76931,-1147
0100000US,United States,310M400US17200,17200,218478,217215,-1263
0100000US,United States,310M400US17220,17220,94197,92822,-1375
0100000US,United States,310M400US17260,17260,26145,22628,-3517
0100000US,United States,310M400US17340,17340,64664,64382,-282
0100000US,United States,310M400US17380,17380,34153,31333,-2820
0100000US,United States,310M400US17500,17500,39143,41556,2413
0100000US,United States,310M400US17540,17540,49117,46518,-2599
0100000US,United States,310M400US17580,17580,48376,49437,1061
0100000US,United States,310M400US17700,17700,35468,32120,-3348
0100000US,United States,310M400US17740,17740,45248,43622,-1626
0100000US,United States,310M400US18060,18060,59779,58930,-849
0100000US,United States,310M400US18100,18100,32237,33363,1126
0100000US,United States,310M400US18180,18180,146457,151132,4675
0100000US,United States,310M400US18220,18220,24301,23047,-1254
0100000US,United States,310M400US18260,18260,106061,112669,6608
0100000US,United States,310M400US18300,18300,63054,64389,1335
0100000US,United States,310M400US18380,18380,23430,22601,-829
0100000US,United States,310M400US18420,18420,37060,36925,-135
0100000US,United States,310M400US18460,18460,43036,45388,2352
0100000US,United States,310M400US18500,18500,98990,95796,-3194
0100000US,United States,310M400US18620,18620,47840,49565,1725
0100000US,United States,310M400US18660,18660,49294,47823,-1471
0100000US,United States,310M400US18740,18740,36898,36629,-269
0100000US,United States,310M400US18780,18780,13791,13188,-603
0100000US,United States,310M400US18820,18820,38121,38346,225
0100000US,United States,310M400US18860,18860,28610,27828,-782
0100000US,United States,310M400US18900,18900,56062,59673,3611
0100000US,United States,310M400US18980,18980,80406,83442,3036
0100000US,United States,310M400US19000,19000,40261,43327,3066
0100000US,United States,310M400US19220,19220,53173,54744,1571
0100000US,United States,310M400US19260,19260,106550,101642,-4908
0100000US,United States,310M400US19420,19420,31800,33044,1244
0100000US,United States,310M400US19540,19540,34387,35636,1249
0100000US,United States,310M400US19580,19580,39030,38165,-865
0100000US,United States,310M400US19620,19620,48879,49208,329
0100000US,United States,310M400US19700,19700,25095,23963,-1132
0100000US,United States,310M400US19760,19760,35654,37253,1599
0100000US,United States,310M400US19860,19860,24199,30997,6798
0100000US,United States,310M400US19940,19940,36031,34223,-1808
0100000US,United States,310M400US19980,19980,33844,33888,44
0100000US,United States,310M400US20060,20060,42354,43093,739
0100000US,United States,310M400US20140,20140,58417,57033,-1384
0100000US,United States,310M400US20180,20180,81616,79388,-2228
0100000US,United States,310M400US20300,20300,21904,21485,-419
0100000US,United States,310M400US20340,20340,45048,43265,-1783
0100000US,United States,310M400US20380,20380,114681,134214,19533
0100000US,United States,310M400US20420,20420,51335,56310,4975
0100000US,United States,310M400US20460,20460,42416,47192,4776
0100000US,United States,310M400US20540,20540,38330,37320,-1010
0100000US,United States,310M400US20580,20580,54258,58485,4227
0100000US,United States,310M400US20660,20660,37777,36968,-809
0100000US,United States,310M400US20780,20780,52196,54993,2797
0100000US,United States,310M400US20820,20820,34246,34208,-38
0100000US,United States,310M400US20900,20900,41280,41619,339
0100000US,United States,310M400US20980,20980,41639,39126,-2513
0100000US,United States,310M400US21020,21020,64094,63771,-323
0100000US,United States,310M400US21120,21120,22119,21709,-410
0100000US,United States,310M400US21180,21180,29405,28823,-582
0100000US,United States,310M400US21220,21220,50929,54463,3534
0100000US,United States,310M400US21260,21260,40909,47364,6455
0100000US,United States,310M400US21380,21380,33692,33406,-286
0100000US,United States,310M400US21460,21460,49952,51909,1957
0100000US,United States,310M400US21540,21540,37069,35857,-1212
0100000US,United States,310M400US21580,21580,40220,39006,-1214
0100000US,United States,310M400US21640,21640,29968,27160,-2808
0100000US,United States,310M400US21700,21700,134611,136373,1762
0100000US,United States,310M400US21740,21740,21121,20299,-822
0100000US,United States,310M400US21840,21840,16840,18381,1541
0100000US,United States,310M400US21860,21860,20843,19785,-1058
0100000US,United States,310M400US21900,21900,56418,56097,-321
0100000US,United States,310M400US21980,21980,24877,24440,-437
0100000US,United States,310M400US22060,22060,64142,66523,2381
0100000US,United States,310M400US22100,22100,65367,66692,1325
0100000US,United States,310M400US22260,22260,57303,58812,1509
0100000US,United States,310M400US22280,22280,51980,55808,3828
0100000US,United States,310M400US22300,22300,74789,75930,1141
0100000US,United States,310M400US22340,22340,17637,16787,-850
0100000US,United States,310M400US22580,22580,67816,66826,-990
0100000US,United States,310M400US22620,22620,28254,25439,-2815
0100000US,United States,310M400US22700,22700,38013,36277,-1736
0100000US,United States,310M400US22780,22780,52274,52014,-260
0100000US,United States,310M400US22800,22800,62095,58741,-3354
0100000US,United States,310M400US22820,22820,28159,28558,399
0100000US,United States,310M400US22840,22840,71116,71385,269
0100000US,United States,310M400US22860,22860,52334,48860,-3474
0100000US,United States,310M400US23140,23140,33219,32250,-969
0100000US,United States,310M400US23180,23180,70730,73478,2748
0100000US,United States,310M400US23240,23240,24836,26804,1968
0100000US,United States,310M400US23300,23300,47711,44753,-2958
0100000US,United States,310M400US23340,23340,36685,36791,106
0100000US,United States,310M400US23380,23380,60946,58799,-2147
0100000US,United States,310M400US23500,23500,55488,57078,1590
0100000US,United States,310M400US23620,23620,38439,40574,2135
0100000US,United States,310M400US23660,23660,52925,50112,-2813
0100000US,United States,310M400US23700,23700,71485,72290,805
0100000US,United States,310M400US23780,23780,40767,40554,-213
0100000US,United States,310M400US23820,23820,46997,48467,1470
0100000US,United States,310M400US23860,23860,60328,62249,1921
0100000US,United States,310M400US23940,23940,46133,46140,7
0100000US,United States,310M400US23980,23980,52275,54206,1931
0100000US,United States,310M400US24060,24060,73538,77720,4182
0100000US,United States,310M400US24100,24100,55520,53591,-1929
0100000US,United States,310M400US24330,24330,45051,45108,57
0100000US,United States,310M400US24380,24380,27215,26746,-469
0100000US,United States,310M400US24460,24460,27672,26111,-1561
0100000US,United States,310M400US24620,24620,68825,69087,262
0100000US,United States,310M400US24640,24640,71377,70963,-414
0100000US,United States,310M400US24700,24700,25739,26794,1055
0100000US,United States,310M400US24740,24740,51135,45063,-6072
0100000US,United States,310M400US24820,24820,52969,51323,-1646
0100000US,United States,310M400US24900,24900,42979,38830,-4149
0100000US,United States,310M400US24940,24940,95110,95282,172
0100000US,United States,310M400US24980,24980,21905,21055,-850
0100000US,United States,310M400US25100,25100,20640,20455,-185
0100000US,United States,310M400US25200,25200,27700,29088,1388
0100000US,United States,310M400US25300,25300,38948,38804,-144
0100000US,United States,310M400US25460,25460,45237,45285,48
0100000US,United States,310M400US25580,25580,31367,31511,144
0100000US,United States,310M400US25700,25700,28452,28710,258
0100000US,United States,310M400US25720,25720,23525,33240,9715
0100000US,United States,310M400US25740,25740,74798,80797,5999
0100000US,United States,310M400US25760,25760,21755,18029,-3726
0100000US,United States,310M400US25780,25780,45419,44582,-837
0100000US,United States,310M400US25820,25820,19372,18760,-612
0100000US,United States,310M400US25840,25840,87062,88888,1826
0100000US,United States,310M400US25880,25880,46686,45749,-937
0100000US,United States,310M400US25900,25900,185076,200983,15907
0100000US,United States,310M400US26020,26020,64727,69611,4884
0100000US,United States,310M400US26090,26090,111407,117327,5920
0100000US,United States,310M400US26220,26220,22346,23428,1082
0100000US,United States,310M400US26260,26260,31613,30067,-1546
0100000US,United States,310M400US26340,26340,38781,38332,-449
0100000US,United States,310M400US26460,26460,63057,59916,-3141
0100000US,United States,310M400US26500,26500,46009,45168,-841
0100000US,United States,310M400US26540,26540,37123,36240,-883
0100000US,United States,310M400US26660,26660,82536,87220,4684
0100000US,United States,310M400US26700,26700,17399,18883,1484
0100000US,United States,310M400US26740,26740,64511,62342,-2169
0100000US,United States,310M400US26780,26780,36645,35873,-772
0100000US,United States,310M400US26860,26860,88889,84501,-4388
0100000US,United States,310M400US26940,26940,29383,25735,-3648
0100000US,United States,310M400US26960,26960,63899,64210,311
0100000US,United States,310M400US27020,27020,30591,29704,-887
0100000US,United States,310M400US27160,27160,33225,32384,-841
0100000US,United States,310M400US27220,27220,31463,34721,3258
0100000US,United States,310M400US27300,27300,40900,38902,-1998
0100000US,United States,310M400US27380,27380,50834,52592,1758
0100000US,United States,310M400US27420,27420,21100,20917,-183
0100000US,United States,310M400US27460,27460,134907,127939,-6968
0100000US,United States,310M400US27540,27540,54598,54975,377
0100000US,United States,310M400US27600,27600,60457,70422,9965
0100000US,United States,310M400US27660,27660,31592,31582,-10
0100000US,United States,310M400US27700,27700,30099,29808,-291
0100000US,United States,310M400US27920,27920,34354,32594,-1760
0100000US,United States,310M400US27940,27940,31275,32113,838
0100000US,United States,310M400US28060,28060,90927,102106,11179
0100000US,United States,310M400US28180,28180,67095,72133,5038
0100000US,United States,310M400US28260,28260,52588,56159,3571
0100000US,United States,310M400US28300,28300,77122,76493,-629
0100000US,United States,310M400US28340,28340,47540,47532,-8
0100000US,United States,310M400US28380,28380,31953,29423,-2530
0100000US,United States,310M400US28500,28500,49625,52405,2780
0100000US,United States,310M400US28540,28540,13519,13918,399
0100000US,United States,310M400US28580,28580,73090,75027,1937
0100000US,United States,310M400US28620,28620,38327,40632,2305
0100000US,United States,310M400US28780,28780,32474,31571,-903
0100000US,United States,310M400US28820,28820,59511,55976,-3535
0100000US,United States,310M400US28860,28860,30035,29938,-97
0100000US,United States,310M400US28900,28900,66380,67653,1273
0100000US,United States,310M400US29060,29060,60073,61022,949
0100000US,United States,310M400US29260,29260,25744,26461,717
0100000US,United States,310M400US29300,29300,67039,70034,2995
0100000US,United States,310M400US29380,29380,67526,70503,2977
0100000US,United States,310M400US29500,29500,13833,12619,-1214
0100000US,United States,310M400US29660,29660,36299,38601,2302
0100000US,United States,310M400US29780,29780,29379,27591,-1788
0100000US,United States,310M400US29860,29860,84834,84889,55
0100000US,United States,310M400US29900,29900,36160,34810,-1350
0100000US,United States,310M400US29980,29980,41851,43734,1883
0100000US,United States,310M400US30060,30060,35571,35713,142
0100000US,United States,310M400US30220,30220,22927,22980,53
0100000US,United States,310M400US30260,30260,44963,44785,-178
0100000US,United States,310M400US30280,30280,30608,33683,3075
0100000US,United States,310M400US30380,30380,46679,46222,-457
0100000US,United States,310M400US30420,30420,26370,25705,-665
0100000US,United States,310M400US30580,30580,22950,21780,-1170
0100000US,United States,310M400US30660,30660,30305,28925,-1380
0100000US,United States,310M400US30820,30820,39240,38684,-556
0100000US,United States,310M400US30880,30880,36754,32607,-4147
0100000US,United States,310M400US30900,30900,38966,37955,-1011
0100000US,United States,310M400US30940,30940,126370,128215,1845
0100000US,United States,310M400US31060,31060,17950,19101,1151
0100000US,United States,310M400US31220,31220,28691,29100,409
0100000US,United States,310M400US31260,31260,86771,87092,321
0100000US,United States,310M400US31300,31300,134229,131831,-2398
0100000US,United States,310M400US31380,31380,32610,29955,-2655
0100000US,United States,310M400US31500,31500,32404,32208,-196
0100000US,United States,310M400US31580,31580,46918,45068,-1850
0100000US,United States,310M400US31620,31620,24552,23537,-1015
0100000US,United States,310M400US31660,31660,51607,50293,-1314
0100000US,United States,310M400US31680,31680,33011,33701,690
0100000US,United States,310M400US31820,31820,81442,79074,-2368
0100000US,United States,310M400US31930,31930,61781,60155,-1626
0100000US,United States,310M400US31940,31940,65778,63417,-2361
0100000US,United States,310M400US31980,31980,70063,65936,-4127
0100000US,United States,310M400US32000,32000,44996,45507,511
0100000US,United States,310M400US32020,32020,66501,65256,-1245
0100000US,United States,310M400US32100,32100,67071,66516,-555
0100000US,United States,310M400US32140,32140,25857,25629,-228
0100000US,United States,310M400US32180,32180,23370,22895,-475
0100000US,United States,310M400US32220,32220,65644,66726,1082
0100000US,United States,310M400US32260,32260,40648,39981,-667
0100000US,United States,310M400US32280,32280,35015,33415,-1600
0100000US,United States,310M400US32300,32300,67996,63855,-4141
0100000US,United States,310M400US32340,32340,23370,22304,-1066
0100000US,United States,310M400US32380,32380,51742,50100,-1642
0100000US,United States,310M400US32460,32460,37129,37317,188
0100000US,United States,310M400US32500,32500,17490,17150,-340
0100000US,United States,310M400US32540,32540,45837,43877,-1960
0100000US,United States,310M400US32620,32620,53535,51889,-1646
0100000US,United States,310M400US32660,32660,39824,40878,1054
0100000US,United States,310M400US32700,32700,29181,28537,-644
0100000US,United States,310M400US32740,32740,88750,85063,-3687
0100000US,United States,310M400US32860,32860,43865,45131,1266
0100000US,United States,310M400US32940,32940,107445,100948,-6497
0100000US,United States,310M400US32980,32980,28743,27689,-1054
0100000US,United States,310M400US33020,33020,25529,25473,-56
0100000US,United States,310M400US33060,33060,31848,31175,-673
0100000US,United States,310M400US33180,33180,28691,26569,-2122
0100000US,United States,310M400US33300,33300,55241,53171,-2070
0100000US,United States,310M400US33420,33420,28122,28875,753
0100000US,United States,310M400US33500,33500,69537,75934,6397
0100000US,United States,310M400US33580,33580,22836,23166,330
0100000US,United States,310M400US33620,33620,25414,24763,-651
0100000US,United States,310M400US33940,33940,41277,42214,937
0100000US,United States,310M400US33980,33980,66463,69524,3061
0100000US,United States,310M400US34020,34020,54650,49774,-4876
0100000US,United States,310M400US34140,34140,37243,40134,2891
0100000US,United States,310M400US34180,34180,89124,97331,8207
0100000US,United States,310M400US34220,34220,45499,45592,93
0100000US,United States,310M400US34260,34260,41513,41619,106
0100000US,United States,310M400US34300,34300,27040,27259,219
0100000US,United States,310M400US34340,34340,73743,71948,-1795
0100000US,United States,310M400US34380,34380,70313,70562,249
0100000US,United States,310M400US34420,34420,32334,33033,699
0100000US,United States,310M400US34460,34460,44398,47037,2639
0100000US,United States,310M400US34500,34500,38825,37820,-1005
0100000US,United States,310M400US34540,34540,60932,61893,961
0100000US,United States,310M400US34660,34660,37190,39135,1945
0100000US,United States,310M400US34700,34700,42749,42929,180
0100000US,United States,310M400US34780,34780,70988,68362,-2626
0100000US,United States,310M400US34860,34860,64524,65711,1187
0100000US,United States,310M400US35020,35020,53121,50764,-2357
0100000US,United States,310M400US35060,35060,39569,38659,-910
0100000US,United States,310M400US35140,35140,37508,38520,1012
0100000US,United States,310M400US35220,35220,49466,48271,-1195
0100000US,United States,310M400US35260,35260,91140,86184,-4956
0100000US,United States,310M400US35420,35420,92587,92176,-411
0100000US,United States,310M400US35440,35440,46033,49388,3355
0100000US,United States,310M400US35460,35460,35642,35774,132
0100000US,United States,310M400US35500,35500,36842,37147,305
0100000US,United States,310M400US35580,35580,25893,25111,-782
0100000US,United States,310M400US35700,35700,47420,46511,-909
0100000US,United States,310M400US35740,35740,48270,48504,234
0100000US,United States,310M400US35820,35820,37590,36426,-1164
0100000US,United States,310M400US35860,35860,28529,27611,-918
0100000US,United States,310M400US35900,35900,69310,68557,-753
0100000US,United States,310M400US35940,35940,59623,58504,-1119
0100000US,United States,310M400US36020,36020,78508,84460,5952
0100000US,United States,310M400US36300,36300,111940,108047,-3893
0100000US,United States,310M400US36340,36340,54992,51266,-3726
0100000US,United States,310M400US36380,36380,39996,41537,1541
0100000US,United States,310M400US36460,36460,80343,76840,-3503
0100000US,United States,310M400US36580,36580,62277,59749,-2528
0100000US,United States,310M400US36620,36620,53938,54276,338
0100000US,United States,310M400US36660,36660,83384,82764,-620
0100000US,United States,310M400US36700,36700,92509,86934,-5575
0100000US,United States,310M400US36820,36820,22382,22000,-382
0100000US,United States,310M400US36830,36830,18728,19759,1031
0100000US,United States,310M400US36840,36840,25996,25631,-365
0100000US,United States,310M400US36860,36860,154901,148163,-6738
0100000US,United States,310M400US36900,36900,44377,44222,-155
0100000US,United States,310M400US36940,36940,36581,36803,222
0100000US,United States,310M400US37020,37020,70663,68192,-2471
0100000US,United States,310M400US37060,37060,47359,54793,7434
0100000US,United States,310M400US37080,37080,57531,60115,2584
0100000US,United States,310M400US37120,37120,50249,48956,-1293
0100000US,United States,310M400US37140,37140,98757,96647,-2110
0100000US,United States,310M400US37220,37220,43945,45346,1401
0100000US,United States,310M400US37260,37260,74368,74163,-205
0100000US,United States,310M400US37300,37300,58459,58057,-402
0100000US,United States,310M400US37420,37420,22537,21895,-642
0100000US,United States,310M400US37500,37500,42090,45325,3235
0100000US,United States,310M400US37540,37540,32349,32358,9
0100000US,United States,310M400US37580,37580,49789,49728,-61
0100000US,United States,310M400US37660,37660,21606,19964,-1642
0100000US,United States,310M400US37740,37740,53594,53889,295
0100000US,United States,310M400US37780,37780,13783,15695,1912
0100000US,United States,310M400US37800,37800,33307,33407,100
0100000US,United States,310M400US37940,37940,36905,35567,-1338
0100000US,United States,310M400US38100,38100,55752,55387,-365
0100000US,United States,310M400US38180,38180,21356,22064,708
0100000US,United States,310M400US38240,38240,88242,98682,10440
0100000US,United States,310M400US38260,38260,39135,39019,-116
0100000US,United States,310M400US38380,38380,36206,33830,-2376
0100000US,United States,310M400US38420,38420,51205,51554,349
0100000US,United States,310M400US38460,38460,82131,80695,-1436
0100000US,United States,310M400US38500,38500,47050,46248,-802
0100000US,United States,310M400US38580,38580,58290,56697,-1593
0100000US,United States,310M400US38620,38620,46562,44161,-2401
0100000US,United States,310M400US38700,38700,38948,35761,-3187
0100000US,United States,310M400US38740,38740,42794,42639,-155
0100000US,United States,310M400US38780,38780,19840,18743,-1097
0100000US,United States,310M400US38820,38820,71404,76737,5333
0100000US,United States,310M400US38840,38840,41433,40769,-664
0100000US,United States,310M400US38920,38920,21382,21561,179
0100000US,United States,310M400US39020,39020,79493,75502,-3991
0100000US,United States,310M400US39060,39060,148291,142067,-6224
0100000US,United States,310M400US39220,39220,21403,20269,-1134
0100000US,United States,310M400US39260,39260,20978,23867,2889
0100000US,United States,310M400US39420,39420,44778,49791,5013
0100000US,United States,310M400US39500,39500,77306,75546,-1760
0100000US,United States,310M400US39700,39700,22136,21515,-621
0100000US,United States,310M400US39780,39780,63440,63916,476
0100000US,United States,310M400US39860,39860,46185,46403,218
0100000US,United States,310M400US39940,39940,50787,52472,1685
0100000US,United States,310M400US39980,39980,68996,65936,-3060
0100000US,United States,310M400US40080,40080,99969,109118,9149
0100000US,United States,310M400US40100,40100,60968,64525,3557
0100000US,United States,310M400US40180,40180,40123,39531,-592
0100000US,United States,310M400US40260,40260,76733,70250,-6483
0100000US,United States,310M400US40300,40300,53497,50923,-2574
0100000US,United States,310M400US40460,40460,46647,44887,-1760
0100000US,United States,310M400US40540,40540,43806,43051,-755
0100000US,United States,310M400US40620,40620,45156,44732,-424
0100000US,United States,310M400US40700,40700,107684,110283,2599
0100000US,United States,310M400US40740,40740,65648,64689,-959
0100000US,United States,310M400US40760,40760,20495,19556,-939
0100000US,United States,310M400US40780,40780,83939,85535,1596
0100000US,United States,310M400US40820,40820,46740,47196,456
0100000US,United States,310M400US40860,40860,61653,58672,-2981
0100000US,United States,310M400US40940,40940,37219,38072,853
0100000US,United States,310M400US41220,41220,50512,53677,3165
0100000US,United States,310M400US41260,41260,31946,30169,-1777
0100000US,United States,310M400US41400,41400,107852,102665,-5187
0100000US,United States,310M400US41460,41460,61700,60203,-1497
0100000US,United States,310M400US41760,41760,40877,44727,3850
0100000US,United States,310M400US41780,41780,77066,74615,-2451
0100000US,United States,310M400US41820,41820,57858,61452,3594
0100000US,United States,310M400US42300,42300,38669,37517,-1152
0100000US,United States,310M400US42380,42380,62704,60833,-1871
0100000US,United States,310M400US42420,42420,38971,37906,-1065
0100000US,United States,310M400US42460,42460,53224,51736,-1488
0100000US,United States,310M400US42620,42620,77078,78727,1649
0100000US,United States,310M400US42740,42740,42201,42542,341
0100000US,United States,310M400US42780,42780,39719,40540,821
0100000US,United States,310M400US42820,42820,43818,38310,-5508
0100000US,United States,310M400US42860,42860,74275,78374,4099
0100000US,United States,310M400US42900,42900,35243,34300,-943
0100000US,United States,310M400US42940,42940,89719,97892,8173
0100000US,United States,310M400US42980,42980,42376,44111,1735
0100000US,United States,310M400US43020,43020,46187,45454,-733
0100000US,United States,310M400US43060,43060,69443,72679,3236
0100000US,United States,310M400US43140,43140,98032,97645,-387
0100000US,United States,310M400US43180,43180,45057,49038,3981
0100000US,United States,310M400US43220,43220,60692,65507,4815
0100000US,United States,310M400US43260,43260,29119,30233,1114
0100000US,United States,310M400US43320,43320,107488,110445,2957
0100000US,United States,310M400US43380,43380,49418,48627,-791
0100000US,United States,310M400US43460,43460,39188,38458,-730
0100000US,United States,310M400US43500,43500,29510,27346,-2164
0100000US,United States,310M400US43660,43660,16919,16866,-53
0100000US,United States,310M400US43700,43700,63061,64623,1562
0100000US,United States,310M400US43740,43740,77737,73952,-3785
0100000US,United States,310M400US43760,43760,55368,54539,-829
0100000US,United States,310M400US43940,43940,24090,25741,1651
0100000US,United States,310M400US43980,43980,16667,16134,-533
0100000US,United States,310M400US44020,44020,16667,17153,486
0100000US,United States,310M400US44260,44260,47671,49599,1928
0100000US,United States,310M400US44340,44340,70246,77296,7050
0100000US,United States,310M400US44460,44460,23506,25733,2227
0100000US,United States,310M400US44500,44500,37900,42446,4546
0100000US,United States,310M400US44540,44540,22709,21528,-1181
0100000US,United States,310M400US44580,44580,58494,55626,-2868
0100000US,United States,310M400US44620,44620,70021,70942,921
0100000US,United States,310M400US44660,44660,77350,82040,4690
0100000US,United States,310M400US44740,44740,20265,19874,-391
0100000US,United States,310M400US44780,44780,61295,61043,-252
0100000US,United States,310M400US44860,44860,35161,36810,1649
0100000US,United States,310M400US44900,44900,26017,24790,-1227
0100000US,United States,310M400US44920,44920,36324,41933,5609
0100000US,United States,310M400US44980,44980,94483,91083,-3400
0100000US,United States,310M400US45000,45000,34895,30802,-4093
0100000US,United States,310M400US45020,45020,15215,14751,-464
0100000US,United States,310M400US45140,45140,46982,48675,1693
0100000US,United States,310M400US45180,45180,94041,90543,-3498
0100000US,United States,310M400US45340,45340,32935,32835,-100
0100000US,United States,310M400US45380,45380,34793,32661,-2132
0100000US,United States,310M400US45520,45520,25211,26505,1294
0100000US,United States,310M400US45580,45580,27151,26215,-936
0100000US,United States,310M400US45620,45620,44724,44448,-276
0100000US,United States,310M400US45660,45660,56742,55207,-1535
0100000US,United States,310M400US45700,45700,40132,40571,439
0100000US,United States,310M400US45740,45740,26173,26035,-138
0100000US,United States,310M400US45860,45860,189925,181111,-8814
0100000US,United States,310M400US45900,45900,143365,149914,6549
0100000US,United States,310M400US45980,45980,32895,33338,443
0100000US,United States,310M400US46020,46020,98745,99696,951
0100000US,United States,310M400US46100,46100,100209,104001,3792
0100000US,United States,310M400US46180,46180,136268,140552,4284
0100000US,United States,310M400US46380,46380,87850,87606,-244
0100000US,United States,310M400US46460,46460,38620,36387,-2233
0100000US,United States,310M400US46500,46500,40099,38754,-1345
0100000US,United States,310M400US46620,46620,26405,26846,441
0100000US,United States,310M400US46740,46740,34171,33615,-556
0100000US,United States,310M400US46780,46780,28759,28281,-478
0100000US,United States,310M400US46820,46820,13868,14041,173
0100000US,United States,310M400US46860,46860,32588,35438,2850
0100000US,United States,310M400US46900,46900,13535,12820,-715
0100000US,United States,310M400US46980,46980,58368,55178,-3190
0100000US,United States,310M400US47080,47080,36351,36080,-271
0100000US,United States,310M400US47180,47180,38440,36895,-1545
0100000US,United States,310M400US47240,47240,16535,17352,817
0100000US,United States,310M400US47340,47340,32888,31280,-1608
0100000US,United States,310M400US47420,47420,22897,22493,-404
0100000US,United States,310M400US47540,47540,45949,45804,-145
0100000US,United States,310M400US47620,47620,41811,39498,-2313
0100000US,United States,310M400US47660,47660,52595,53652,1057
0100000US,United States,310M400US47700,47700,77354,79344,1990
0100000US,United States,310M400US47780,47780,31654,33147,1493
0100000US,United States,310M400US47820,47820,47768,47079,-689
0100000US,United States,310M400US47920,47920,29035,28666,-369
0100000US,United States,310M400US47980,47980,27225,28015,790
0100000US,United States,310M400US48020,48020,83683,85129,1446
0100000US,United States,310M400US48100,48100,27731,27245,-486
0100000US,United States,310M400US48180,48180,55067,55069,2
0100000US,United States,310M400US48220,48220,27469,29036,1567
0100000US,United States,310M400US48460,48460,40398,40076,-322
0100000US,United States,310M400US48500,48500,20634,19386,-1248
0100000US,United States,310M400US48580,48580,102228,103718,1490
0100000US,United States,310M400US48780,48780,22399,35350,12951
0100000US,United States,310M400US48820,48820,42239,42855,616
0100000US,United States,310M400US48940,48940,42035,42057,22
0100000US,United States,310M400US48980,48980,81218,81455,237
0100000US,United States,310M400US49080,49080,16521,16786,265
0100000US,United States,310M400US49100,49100,51461,50825,-636
0100000US,United States,310M400US49220,49220,74749,73055,-1694
0100000US,United States,310M400US49260,49260,20081,20222,141
0100000US,United States,310M400US49300,49300,114516,115967,1451
0100000US,United States,310M400US49380,49380,21378,21924,546
0100000US,United States,310M400US49460,49460,22438,22869,431
0100000US,United States,310M400US49780,49780,86086,86183,97
0100000US,United States,310M400US49820,49820,14018,14190,172
0100000US,United States,0400000US72,72,3726157,3195153,-531004
0100000US,United States,04000E0US72,72,130989,117214,-13775
0100000US,United States,310M400US10260,10260,19483,17302,-2181
0100000US,United States,310M400US17620,17620,40512,37845,-2667
0100000US,United States,310M400US17640,17640,31078,27083,-3995
0100000US,United States,310M400US27580,27580,16642,13947,-2695
0100000US,United States,310M400US42180,42180,23274,21037,-2237
